8 8 1 50
########
#      #
#.//$  #
#  #  $#
# .$$..#
#  $   #
#.#  @ #
########
