7 7 13 15
  #### 
  # /# 
### $# 
#/@..##
# $.$ #
##    #
 ######
