8 8
########
#.  .  #
#      #
#  #   #
#  $$. #
# $$   #
#.#  @ #
########
