8 8 30 50
########
#.  .  #
#/     #
#  #   #
#  $$. #
# $$  /#
#.#  @ #
########
