7 7 0 50
  #### 
  #  # 
### $# 
# @..##
# $.$ #
##    #
 ######
