8 8 0 50
########
#.  ...#
#/   $$#
#  # . #
#  $$  #
# $$  /#
#.#  @ #
########
