8 8 0 32
########
#.  ...#
#/   $$#
#  #   #
#  $$. #
# $$  /#
#.#  @ #
########
