11 24 0 3
#    #   #        ####  
#    #   #        #   # 
#    #   #        #    #
#    #   #        #    #
#    #   #        #    #
#    #   #        #  ## 
#    #   #        #   # 
#/   #   #        #   .#
#    #   #        #   $#
#@   #   #        #   /#
 ####    ######   ##### 
