14 10 30 50
##########
#.  .    #
#        #
#  #     #
#  $$.   #
# $$     #
#.#  @   #
#        #
#        #
#        #
#        #
#        #
#        #
##########
