10 10 47 60
##########
##########
## $.##  #
## .  #$ #
# @      #
# $ ..#  #
#   $.#$##
#        #
##########
##########
