11 11 0 60
   ####    
   #  #    
  ##$ #### 
 ##.  ##.# 
 # $ .## # 
##       ##
# $       #
#  .  .@$ #
# $#  #####
#  ####    
####       
