11 11 140
    ###    
  ## # ####
 ##  ###  #
## $      #
#   @$ #  #
### $###  #
  #  #..  #
 ## ##.# ##
 #      ## 
 #     ##  
 #######   
