12 11 0 50
   #####   
   #   #   
####$# ### 
# ## # .@# 
#  #  $ ## 
#$ # $  #  
#.    . ## 
# $    $ ##
### .     #
  #.    ###
  #.  ###  
  #####    
