15 15 0 50
          #### 
   ###    #  ##
   #.#    #$  #
   # #    # $ #
#### #    #   #
#  . ######   #
# $$          #
## #  ## ## .##
 #   @## ##$## 
 #$##### .  ## 
 # #   # #   # 
 #.#   # ..  # 
 ###   #$  ### 
       #  ##   
       ####    
