9 9 0 50
  ###### 
###    # 
#    . # 
# $@$..##
#  . .. #
##$  .  #
 # $$$$ #
 #      #
 ########
