11 12 0 50
 ####       
 #  ####    
 #$ # .#    
 #  ## #    
 #  # @#####
##  $    . #
#   .    $ #
#   . .$#$##
##$#.$.   # 
 #      ### 
 ########   
