10 10 0 45
   ####   
 ###  ####
 #  @$   #
## ## .$ #
# ..$ .###
# $ .  ## 
##      # 
 #  ##$ # 
 #####  # 
     #### 
