18 20 0 1000
           ######## 
        ####..##  # 
        #     /# $# 
    #####$##      # 
    #.    ### .##$# 
   ###    $     # ##
  ##.              #
  #@       ###  $  #
####  . #### # $####
#/   . .#    #  #   
#    #  #    #  #   
##  #####    #  ####
 #$ #        #   $ #
 #  #      ###   $ #
 ####      #.   #  #
  ###      ###$   ##
  # #      #.    ## 
  ###      #######  
